                          #######                          
                        ### # # ###                        
                      ##### # # #####                      
                    ###     #   #   ###                    
                  ##### ####### ### #####                  
                ### #         # #       ###                
              ##### # ####### # # ##### #####              
            ### #   #     # #   #   #   #   ###            
          ##### # # ##### # ####### # ### # #####          
        ###   #   #     #   #   #   # #   # #   ###        
      ##### # ##### ####### # # # ### # ### # #######      
    ###     #       #     # # # # #   # #   #       ###    
  ##### ### ##### ### # ### # # # # ### ### # ### #######  
### #   # #   #   #   #   #   #   #   #   # #   #       ###
### # ### ### ##### ##### ########### ### # ####### # #####
#S#   #     #     # #   #           # #   #       # #     #
# # ### # # ##### # # # ####### ### # # ######### # ### ###
# # # # # # #   #   # #     #   #   #   # #     # # # #   #
# # # # # # ### ########### # ########### # # ### # # ### #
# # #   # # #           #   # #     #   #   #     #   #   #
# # ##### # # ######### # ### # ### # # # ########### # # #
#       # #   #       #   #   # # #   # # #   #       # #G#
####### # ##### ##### ### # # # # ##### # # # ######### ###
###     # #   # #     #   # # # #     #   # #           ###
  ##### # # # # ##### ##### # # ##### ##### ####### #####  
    ###   # #   #   #       # # #     #   # # #     ###    
      ##### ##### # ##### ##### # ### # # # # # #####      
        ###     # #     # #     #   # # # # #   ###        
          ##### # ##### ### ####### # # # # #####          
            ###       #     #     # # # #   ###            
              ####### ######### # # # # #####              
                ###       #     # # #   ###                
                  ####### # ##### # #####                  
                    ###     #       ###                    
                      ####### #######                      
                        ###     ###                        
                          #######                        
