###########################################################################################
#S    #             #                           #         #     #         # #   #         #
##### # ####### # ### ####################### # # ##### # ### # ### ##### # # # # ### ### #
# #   # #     # #   #   #           #       # #   #     #     #     #   # #   #     #   # #
# # ### # ### # ### ### # ######### # ##### ####### ################# # # # ########### # #
# # #   #   # #   #   # #       #   #   # #   #   # #     #     #     # # #   #   #     # #
# # # ##### # ### # ### ####### # ##### # ### # # # # ### ### # ### ### # ### # # # ##### #
#   #   #   # #   #     # #     # #     #     # # #   # # #   #     #   # # # # #   # #   #
# ##### # ### ####### ### # ##### ### ### ##### # # ### # # ####### ##### # # # ##### # ###
# #     #   #       #     # #   #     # # #     # #     # #     #   #     #   #   # #     #
# # ####### ####### ##### # # # ####### # # ##### # ##### ##### # ### ##### ##### # # #####
# #       # #   #   #   # # # #       #   #   #   # #   # #     #   #     #     # #   #   #
# ######### # # # ### # # # # # ##### # ##### # ##### # # # ##### ####### ####### ##### # #
# #         # # # #   # # # # # #     #       #       #   # #   # #       #     #   #   # #
# # ########### # ### # ### # # ########################### # # # # ####### ### # # # ### #
#   # #       # # #   #     # # #                         # # #   #         #   # #     # #
##### # # ### # # # ########### #                         # ##### ########### ### ####### #
#     # # # #   #   #   #     # #                         #     # #   #     #   # #       #
# ### # # # ### ##### # ### # # #                         # ### # # ### ### ### # # ##### #
# #   # # #           # #   # # #                         # # # #   #   # #   # # #   # # #
# ##### # ############# # ### # #                         # # # ##### ### ### # ##### # # #
#     # # #   # #   #   # #     #                         #   # #     #   #   #   #   #   #
# ### # # # # # # # # ### ##### #                         ##### # ####### # ##### # # #####
#   #   # # # #   #   #       # #                         #     #   #   # #       # # #   #
### ##### # # # ######### ### # ########################### ### ### # # # ######### ### # #
# # #   #   # #         #   # # #   #                       # #   #   #     # #       # # #
# # ### ##### ######### ##### # ### # ### ######### ######### ### ######### # # ##### # # #
# # #       #       # #   #   #     # # # #       # #   #       # # #   #   # # #   #   # #
# # # ##### ####### # ### # # ####### # # # ##### # # # ### ### # # # # # ### # # # ##### #
# #   #     #       #       # #       # # # #   # # # #   # #   #   # #   #   # # #   #   #
# ### ####### ####### ######### ####### # # ### # ### ### ### ##### # ####### # # # # # # #
#   # #       # #     #         #       # #   # #     # #   # #     # #     # # # # # # # #
# # # # ####### # ##### ############### # ### # ####### ### # # ##### # # # # # ### # # # #
# #   #       #     #   #     #         #   #         # #   #     #   # # # #   #   # # # #
# ########### ####### ### ### # ####### # ########### # # ### ##### ##### # ### # ##### # #
#     #     #     #   #   # # # # #     #     #       # #   # #   #   #   #   #   #   # # #
##### ### # ##### # ##### # # # # # ######### # ####### ### ### # ### # ##### ##### # # # #
#         #     #         #     #           #             #     #       #           #   #G#
###########################################################################################
