   ################################################################################################################################################################################################################
#S          #  #  #  #                    #           #           #           #              #     #     #  #  #        #           #  #                 #           #  #     #                 #           #     #
####  ####  #  #  #  #######  #  ##########  #  #######  #######  ####  #  ####  ##########  ####  #  #  #  #  #  #  ##########  #  #  #  ##########  ##########  #  #  ####  #  #############  #  ##########  #  #
#     #                 #     #  #     #     #     #        #     #  #  #     #  #                    #           #     #  #     #        #        #     #     #  #        #     #        #  #     #           #  #
#######  ################  #######  #  ####  #  #############  ####  ####  #  ####  ##########  #  #######  #############  #  ################  ####  #  ####  #  ##########  ##########  #  ####  #######  ####  #
#     #     #                       #  #     #                 #  #  #     #        #        #  #  #     #  #  #     #  #        #     #  #     #     #        #        #                 #           #  #  #     #
#  #######  ####  ##########  #  #######  #  #  #######  #######  #  #######  #############  #  #  #  #######  ####  #  #######  #  ####  ####  ####  #  #######  #  #  #  ####  ################  #  #  ####  ####
#        #        #           #           #  #     #        #  #        #        #           #  #                    #     #  #        #        #     #           #  #     #        #           #  #        #  #  #
####  ##########  #############  ####  #  ##########  #  #  #  #  ################  ################  #############  ####  #  #  #############  #############  ####  ##########  #######  #############  #  #  #  #
#                    #  #     #  #     #  #        #  #  #  #  #                    #     #        #  #  #  #  #     #        #  #  #  #           #     #     #     #        #        #                 #     #  #
#  #######  #######  #  ####  ##########  #  #  #  #  #######  #  ####  ##########  #  #  #  ##########  #  #  #  #  #######  ####  #  #  ####  ####  #######  ##########  #############  #  ###################  #
#        #        #        #              #  #  #  #     #     #  #     #     #  #     #     #                    #  #  #  #     #  #     #           #           #  #           #  #     #  #        #     #     #
#######  #  #  #  ####  ##########  ####  #  #######  #######  ##########  ####  #######  #######  #  ##########  ####  #  ####  #  ####  #  #############  #  #  #  ####  #  ####  ####  ##########  ####  ####  #
#        #  #  #     #  #        #     #     #  #                             #  #     #           #        #        #  #        #        #  #  #     #  #  #  #  #        #           #        #        #  #     #
####  #######  #######  #######  #  #######  #  ####  ##########  #######  #  #  #  ####  #  #######  ####  ####  #  #  ####  ####  ##########  #  ####  #######  #  #  ####  #######  ####  ##########  #  ####  #
#  #  #     #  #  #        #        #     #  #  #     #        #        #  #  #           #  #  #        #  #     #     #     #     #  #  #     #        #     #  #  #  #     #        #     #     #  #           #
#  #  #  #######  ##########  ####  #  ####  #  #######  #  #  #  ##########  #  #  #  #######  #  ##########  #######  ####  #  #  #  #  ####  #  ####  ####  #  #  ####  ##########  #  #  #  ####  #  #  ####  #
#     #     #           #  #     #        #     #  #  #  #  #  #  #  #  #        #  #  #        #  #  #     #  #     #        #  #     #           #  #  #        #     #     #  #        #     #        #     #  #
####  #  ####  #######  #  ####  #  ##########  #  #  #  ##########  #  #######  #  ####  ##########  ####  ####  ####  #############  ####  #  ####  #  #######  ####  #  #  #  #  ##########  #  ####  #  #######
#  #  #     #  #     #        #  #     #  #              #                    #  #                 #        #     #     #     #     #     #  #  #        #        #  #  #  #     #     #              #  #  #     #
#  ####  #######  #######  ####  ####  #  #########################  ####  ####  ####  #  ####  #######  #######  #  ####  #  #  ####  #  #  ####  ##########  ####  #  #######  ####  #  #  #############  ####  #
#  #        #  #  #     #  #        #  #        #     #           #     #     #  #     #  #     #           #     #        #           #  #  #  #  #     #     #        #  #     #     #  #  #        #  #        #
#  ####  ####  #  #  ####  ####  #######  ##########  ##########  ##########  #  #######  #  #  ####  ####  ####  ##########  #######  #  ####  #  #  #  ####  #  #  #  #  ##########  #######  ####  #  #  #  #  #
#     #                 #     #           #  #           #        #     #  #        #  #  #  #  #  #  #     #        #  #           #  #     #  #     #  #  #  #  #  #  #  #  #     #           #        #  #  #  #
#  ##########  #######  #  #  #  ####  #  #  #  #############  #######  #  #######  #  #  #######  ####  #######  #  #  #  ##########  #  ####  #  ####  #  #  #  ####  #  #  #  #######  #  #######  ####  #######
#                    #     #     #     #  #     #     #        #           #     #     #        #  #  #  #  #     #           #     #  #  #        #     #     #  #  #  #  #  #  #     #  #        #  #        #  #
##########  ####  #######  ####  #  ##########  #  ##########  #  #  #  #######  ####  ####  #  #  #  #  #  #######  ####  #  ####  #  #  ##########  ####  #######  #  #  #  #  #  #  #######  #######  #  #  #  #
#              #  #        #     #  #                    #        #  #     #  #        #  #  #  #     #     #  #  #  #     #        #  #  #              #  #              #        #     #  #        #  #  #  #  #
####  #######  #  #  ####  #  ##########  #######  #############  #  ####  #  #  #  #  #  #  #  #  ####  ####  #  #  #######  ####  #  ####  ##########  ##########  #############  #######  #  ####  ####  #  #  #
#     #  #     #  #  #     #  #     #        #        #           #  #  #  #     #  #  #  #  #     #        #  #  #        #  #     #     #     #  #     #        #     #     #        #  #     #     #     #     #
#######  ####  ####  #############  #  #  #######  ####  #######  ####  #######  #  ####  ####  #######  ####  #  ####  #  ####  #######  #  #  #  ##########  #######  ####  ####  ####  #  ###################  #
#        #  #  #     #                 #        #           #  #  #        #     #  #  #     #     #  #  #        #     #  #     #        #  #     #        #     #        #  #        #  #           #  #  #  #  #
#  #######  #######  #######  ##########  #######  #  #######  #  ####  #  ##########  #  #  #  #  #  #  #######  ##########  #######  #  #  ##########  ####  ####  #  ####  ####  ####  ####  #######  #  #  #  #
#     #  #     #  #  #        #     #     #  #     #  #                 #  #              #     #  #              #  #        #        #  #        #           #  #  #  #        #     #  #     #        #  #     #
#  ####  ####  #  ####  #######  ####  ####  #  ####  #######  ####  #############  #  ####  ##########  ##########  #  #  #############  #  #######  ####  ####  #  #  #######  ####  #  #######  ####  #  ####  #
#  #     #     #     #  #     #  #  #     #  #  #     #        #  #     #  #  #     #     #  #              #           #  #  #     #        #        #              #  #  #              #     #     #  #        #
#  #  #  ####  #  ####  #  #  #  #  #######  ################  #  #######  #  ###################  ####  ####  ##########  #  ####  #  ####  #  #  #  #  ####  #  #  ####  #  ####  ####  ####  #  #############  #
#     #        #        #  #     #        #  #           #        #              #           #        #  #     #           #     #     #  #     #  #  #     #  #  #     #        #     #              #     #     #
#######  #  ##########  ####  ####  #######  ####  ####  ####  #############  #############  ####  ####  ####  ####  ####  ####  #  #  #  #  #  ####  #######  #  ################  ####  #  ##########  #  ####  #
#     #  #  #  #                    #  #           #  #              #        #  #  #     #  #     #  #  #     #  #  #     #  #     #  #     #  #     #     #  #        #  #  #     #     #  #        #  #  #     #
#  #######  #  #######  #  #######  #  ##########  #  #  ####  #  ####  ####  #  #  #  ####  ####  #  #  #  ####  ####  ####  #############  #  ##########  #  ##########  #  #  #  ##########  #  #  #  ####  #  #
#        #  #     #  #  #     #  #  #  #           #        #  #  #  #  #     #  #  #  #     #     #     #  #        #     #                 #              #     #     #        #     #        #  #  #  #     #  #
####  ####  ####  #  #  #  ####  #  #  ###################  ####  #  #  #  ####  #  #  ####  ##########  #  #  #######  #  ######################  ####  ##########  #  #######  #  ####  #  ####  #  #  #  ####  #
#     #  #           #  #     #  #           #     #        #        #  #  #        #     #     #  #           #        #  #           #        #     #  #     #  #  #           #  #     #  #     #     #  #  #  #
####  #  #  ####  #  ####  ####  ####  ####  ####  ##########  ####  #  #  #  #######  #######  #  #######  #######  ####  ####  ####  #  ####  #  #  #  #  ####  ####  ####  #  ################  ####  ####  ####
#  #  #        #  #     #     #           #     #                 #  #  #     #        #     #        #           #     #        #  #  #  #     #  #  #  #        #  #     #  #  #           #  #  #     #        #
#  #  #######  #  #######  #  ####  #  #  #  #  ####  #  ##########  #######  #######  #  ####  #######  ####  #  #  #  ####  #  #  #######  ################  ####  #######  #######  #  #  #  #######  #  #######
#              #     #     #  #  #  #  #  #  #  #  #  #     #           #  #     #  #                    #     #  #  #     #  #  #  #  #           #     #  #     #  #  #        #  #  #  #     #     #     #  #  #
#  #######  #  ####  #  #######  ##########  #  #  #######  #######  ####  ####  #  #  #######  #  ######################  ####  #  #  #  #######  #  ####  ####  #  #  #  #######  #  ####  ####  #  ####  #  #  #
#  #        #  #           #     #     #     #  #  #  #  #        #  #        #     #     #     #  #     #  #     #     #     #  #              #  #  #        #           #        #  #           #        #     #
#  #  #  ####  #  #  #  #######  #  #######  #  #  #  #  #######  ####  #######  ####  #######  #######  #  #  ####  #######  ####  #############  #  #  ####  #######  #  #  #  ##########  #  #######  #  ####  #
#  #  #  #     #  #  #     #  #              #  #  #  #        #  #              #     #     #              #  #     #     #  #  #  #                 #     #  #     #  #     #  #           #        #  #        #
#  ####  ####  ####  #######  ##########  ####  #  #  #  ####  #  ####  ####  #  #  #  ####  #  #  ####  #  #  ####  ####  #  #  ####  #############  #######  ####  #  #  ####  ##########  #######  #  ##########
#     #  #     #  #  #     #  #     #  #  #           #     #           #  #  #  #  #  #     #  #  #     #  #                             #        #        #        #  #  #  #                 #     #  #        #
#######  ####  #  #  #  ####  #  #  #  #  ####  ####  #  ################  #  #  ####  ####  ##########  ####  #############  ####  #  #  #  #######  #  #  #  ####  #  ####  #######  ####  ##########  #######  #
#        #     #  #  #        #  #        #     #  #  #     #        #        #  #     #     #     #     #     #     #        #  #  #  #  #        #  #  #        #  #        #  #        #     #  #     #     #  #
################  #######  ####  #  #  ####  ####  #  ##########  ##########  ####  #######  ####  ##########  #  ####  ####  #  #  #  ####  ##########  #######  #  #  ####  #  #  ####  #  ####  #  ####  #  #  #
#     #              #  #        #  #  #        #           #        #     #           #           #     #     #        #     #     #           #  #     #        #  #  #     #  #  #  #  #  #     #        #  #  #
#  ####  #  ####  ####  #######  #######  #  #  ####  #  ####  ##########  ####  #  ####  #######  #  #  #############  ####  #######  #  ####  #  ####  ####  ################  ####  #  #  #  ################  #
#        #     #        #        #        #  #  #     #  #        #           #  #  #  #        #     #  #                 #  #     #  #  #     #     #  #  #     #  #     #     #  #     #     #     #           #
#  ####  ####  ####  #  #############  #  ####  #  #  #######  #  #  #  #  ####  ####  ################  #  #  #  ##########  #  #######  #######  ####  #  ####  #  #  #######  #  ####  ####  ####  #  #######  #
#  #     #  #     #  #     #  #     #  #  #     #  #  #     #  #  #  #  #  #  #  #  #  #     #  #  #  #     #  #  #        #           #     #        #  #  #  #     #        #     #  #     #                 #  #
####  ####  ####  #  #  #  #  #  #  #  #######  ##########  ####  ####  ####  #  #  #  ####  #  #  #  #  #######  #  #  #######  #######  #  ####  ####  #  #  #  ####  ##########  #  #  #  #############  ####  #
#  #     #  #  #  #  #  #     #  #  #        #  #  #        #              #  #     #  #  #     #  #  #        #  #  #     #           #  #  #  #  #        #     #  #  #           #  #  #        #        #     #
#  #  ####  #  #  #############  #######  #######  ####  #  #  #######  #  #  #  ####  #  ####  #  #  #######  ####  #  #  #  #  #  ##########  #  #  #######  ####  #  ####  ####  #  #  ####  ####  #  #######  #
#           #              #  #  #  #     #  #        #  #  #        #  #  #           #     #  #  #     #        #  #  #  #  #  #     #     #           #  #                    #  #        #     #  #     #     #
#######  #  ##########  ####  #  #  #  #  #  ####  ####  ####  #  #######  ####  #######  ####  #  ####  #  ####  #  ####  ####  #  #  #  ################  #  ################  #  #  #  #######  #  #######  ####
#        #     #  #  #     #        #  #        #        #     #  #  #        #     #     #  #     #           #  #     #     #  #  #     #  #     #  #  #     #        #        #  #  #  #  #     #        #  #  #
####  ####  #  #  #  #######  #############  ####  #######  #######  ####  #############  #  #  #######  ####  #  ##########  #######  #  #  #  #  #  #  #  ##########  #######  #  #  #  #  ####  ##########  #  #
#        #  #                    #  #        #  #        #  #  #        #  #                    #        #     #  #        #        #  #  #     #  #           #     #  #        #     #  #           #  #  #     #
#  #######  #  #######  ####  #  #  #  #  ####  #  #  ####  #  #  #  ####  ###################  #  #  ###################  ####  #  #######  #  ###################  #  #######  ####  #######  ####  #  #  #  ####
#     #     #  #        #     #     #  #     #     #  #  #     #  #              #                 #  #              #  #  #     #     #  #  #     #           #     #              #  #  #  #     #     #     #  #
#  ####  #######  ####  ##########  #  #######  #  #  #  #  ##########  #  ####  #  #######  #############  ####  ####  #  #  ##########  #  #  #  #  #############  #  #######  #######  #  ####  #  #  ####  #  #
#  #     #     #  #  #        #     #  #     #  #  #        #     #     #     #           #  #                 #  #  #     #        #        #  #           #  #  #  #  #        #  #     #  #     #  #     #     #
#  ##########  ####  ##########  #  ####  ####  #  #  ####  #  #  #  #  ####  #  #  ####  #  #  #############  ####  ####  #######  #  ####  ####  ##########  #  #  #  ####  ####  ####  #  #  ##########  #  #  #
#  #        #     #        #     #     #  #  #  #  #     #     #  #  #  #     #  #  #     #     #     #        #     #  #  #  #     #     #  #  #  #     #        #        #  #  #           #           #  #  #  #
#  ####  #  ####  #  ####  #######  ####  #  #######  ##########  ####  #  ##########  #  #  #  #  #  #######  #  ####  #  #  #  #######  ####  #  ####  #  #  ##########  #  #  #  ####  ####  ####  #  #######  #
#     #  #        #  #  #                          #  #  #  #     #     #     #        #  #  #  #  #     #              #        #  #     #  #     #     #  #           #  #           #     #     #  #     #     #
#  #  #  #############  ####  ####  ####  ####  #  ####  #  #########################  ##########  #######  #  ##########  #  ####  ####  #  #  ####  ##########  #  ####  #  ##########  #  ################  ####
#  #     #           #     #  #     #        #  #           #  #  #              #  #     #           #     #        #  #  #        #  #  #     #     #        #  #        #  #        #  #                 #     #
#  #######  ####  #######  #  ####  #######  #  ####  #######  #  ####  #######  #  ##########  ####  #  #######  ####  ####  #  ####  #######  #  ####  #  #######  ####  #######  ####  #  #############  #######
#  #        #     #           #           #  #     #              #  #     #     #                 #  #  #     #     #  #     #        #        #     #  #           #  #  #  #           #     #              #  #
#  #  #  ####  #  #######  #  ####  ####  #  #######  #  #  ####  #  #  #  ##########  ##########  ####  #  #  #  ####  #############  #  ##########  ####  ####  ####  ####  #  ####  ####  #######  #######  #  #
#     #  #  #  #  #  #     #  #  #     #  #     #     #  #     #        #  #           #  #     #        #  #  #        #  #     #        #              #     #  #        #        #  #           #     #        #
#  #  ####  ####  #  ##########  ###################  ##########  ####  ##########  #  #  ####  ####  ####  ####  #  ####  ####  ####  #  #  #  #  ################  #  ####  ###################  ####  #######  #
#  #        #           #  #     #  #              #  #     #        #  #           #  #  #     #        #        #                    #  #  #  #  #              #  #     #  #        #  #  #     #           #  #
####  #  #  ####  #  ####  ####  #  #######  #  ##########  #  ####  ##########  #  ####  #  #  #  #######  ################  ####  #######  #############  #  ####  #  #  #  ####  #  #  #  ####  ####  #  ####  #
#     #  #  #     #     #                    #  #           #     #     #        #  #        #  #     #  #     #           #  #           #           #     #     #  #  #  #  #     #  #  #        #  #  #  #     #
#  ##########  #  #  #######  ####  #######  ####  ####  #  #  #######  ################  #  #  #  ####  #  #  ##########  ####  #######  #  #######  ####  ####  #  #############  ####  ####  ####  #############
#     #  #     #  #              #     #  #     #  #     #  #  #           #        #     #  #  #     #     #  #                    #           #     #        #  #     #     #     #  #        #     #           #
#  ####  ####  #  #  #######  #######  #  ##########  #######  ####  #  #  ####  ##########  ################  ####  #######  ####  #######  #######  ####  #######  #  #  #  #  ####  #  #  ####  #  #  #  #######
#  #           #  #        #  #     #        #        #        #     #  #  #                    #        #     #        #        #  #     #  #        #  #           #     #  #  #     #  #        #     #  #  #  #
#  #  #  #############  #  ####  ####  ##########  #  ####  ##########  #  ####  #  #  #  #############  #  #  ###################  ####  #############  #  ####  #######  ####  #  #######  ####  #  #######  #  #
#  #  #  #           #  #  #  #        #  #        #  #        #  #     #        #  #  #                 #  #     #        #        #     #  #  #  #           #  #        #  #           #  #     #     #        #
################  ####  ####  ####  ####  ####  #  #  #  #######  #  #######  #############  ####  #######  #  #######  ####  ####  ####  #  #  #  #  #  #  #######  #######  ####  #  #############  #  #  #  #  #
#     #     #     #  #        #  #     #  #     #  #        #  #  #     #  #        #        #  #  #  #     #     #     #  #     #  #  #  #        #  #  #     #     #              #                 #  #  #  #  #
#  #######  #  ####  #######  #  #  ####  #  ####  #  #######  #  ####  #  #######  #######  #  ####  ####  #  #  #  ####  #  #######  #  #  #  #############  ####  #  #######  #  ####  ####  #  ##########  ####
#                 #     #        #  #  #        #  #                 #  #  #     #     #  #     #           #  #  #  #  #  #     #  #  #     #     #  #     #     #  #  #  #  #  #     #  #  #  #  #  #     #     #
#  #######  #######  #  #  #  #  ####  ##########  #######  ##########  #  ####  ####  #  #  #  ####  #######  #  #  #  #  #  #  #  #  #######  ####  #  ####  #  ####  #  #  ##########  #  ####  #  ####  ####  #
#        #           #     #  #     #                    #     #                    #  #     #              #  #  #           #                       #        #                    #     #                      G#
###################################################################################################################################################################################################################
