#################################################                                                    
#S  # #         #         #   #   #           # #                                                    
### # # ##### ### ### ### # # # ### # ####### # #                                                    
#   #       #     #   # #   # #     #     # #   #                                                    
# ### ####### ##### ### ##### # ######### # ### #                                                    
#   # #     # #     #       # #     #     #     #                                                    
### ### ### ### ##### # ##### # ##### ##### #####                                                    
# # #   # #   # #     # #   # # #     #     #   #                                                    
# # # ### ### # # ####### # # # # ##### ####### #                                                    
# # #   #   #   #         # # # # #   #     #   #                                                    
# # ### # # ##### ######### # ### # ####### # ###                                                    
# #     # #   #   #     #   # #   #       # #   #                                                    
# ######### # # ### ### # ### # ### # ##### ### #####################################################
#     #     # # #   #   # #   # # # #     #   #         #             #                             #
# ### # # ##### ### ##### # ### # # ##### ### # # ##### ##### # ##### # ################# ######### #
#   # # # #   # #   #     # #   #   #   #   # # # #   #     # # #     #     #       #     #   #   # #
# # ### # # # # # # # ##### # ### ### # # # # ### ### ##### # # # ######### # ##### # ##### # # # # #
# #     #   # #   # #   #   #   #   # # # # #   #   #     # # # #     #     # # #   #     # # # #   #
# ########### ##### ### # ##### ### # # # ##### # # # ##### # # ##### # ##### # # ### ### # # # #####
#         #     #   #   # #     # # # # #     # # # #       # #   #   # #     # #   # #   # #   #   #
######### # ##### ### # # # ##### # # ####### # ### ##### ####### # ##### ##### ### ### ### ##### # #
#   #     #       #   # #   #     # #       # #   #     # #     # #     # # #     #   #   #   #   # #
# # # ############# ######### ### # ### ### # ### ##### # # ### # ##### # # # ### ### ### ### ### # #
# #               #             #       #   #           #   #     #       #     #         #       #G#
#####################################################################################################
