###########################################################################################
#S #  #                                   #     #  #  #              #     #              #
#  #  ################  #######  ####  ####  ####  #  ####  #  ####  #  #  #  #  #  #######
#  #                    #     #  #  #     #     #     #     #     #  #  #     #  #     #  #
#  ####  ####  #  #######  #######  #  ####  #  ####  #  ################  #############  #
#  #        #  #                    #  #  #  #  #        #     #  #  #     #     #        #
#  #  ##########  ####  #######  #  ####  #  #######  #  #  ####  #  #  ####  #  #  ####  #
#  #     #     #  #  #     #     #        #           #     #  #  #  #     #  #        #  #
#  ####  #  #######  #######  #######  ##########  ##########  #  #  ####  #  #  ##########
#           #  #  #  #  #           #  #                 #  #     #  #  #     #  #        #
#  #  #  #  #  #  #  #  ####  #  #  #######  #  #######  #  #  #  #  #  ####  ####  ####  #
#  #  #  #  #              #  #  #  #  #     #  #           #  #  #  #        #        #  #
#######  #  #  ####  #  #  #  ####  #  #  ##########  #######  #  #  #  ####  #  #######  #
#  #  #  #  #     #  #  #  #  #  #           #  #           #  #  #     #           #  #  #
#  #  #######  #  #######  ####  ####  #######  #  #  ####  #  #######  ####  ####  #  #  #
#        #  #  #  #     #  #     #              #  #  #        #        #        #     #  #
####  #  #  #  ####  #######  #  #  ##########  #  #  ##########  #  ####  ####  ####  #  #
#     #              #  #     #        #        #  #  #        #  #     #  #     #  #  #  #
################  #  #  #######  #  #######  ####  ##########  #  ####  ####  #  #  #######
#     #     #     #        #  #  #        #     #     #           #        #  #        #  #
#  ####  #  #  #######  #  #  ####  #######  #  #  #######  ####  ######################  #
#     #  #  #  #  #     #     #  #  #        #  #     #        #  #  #  #        #        #
#  #######  ####  #######  ####  #######  #  #  #  ##########  ####  #  ####  ####  ####  #
#        #           #           #     #  #  #  #     #     #     #        #        #     #
#  #######  #  #  ##########  ####  #  #######  ####  ####  ####  #######  ####  ##########
#  #     #  #  #  #     #  #     #  #  #  #     #        #                          #  #  #
#  #  #  ####  #######  #  #  #  #  #  #  #  #######  #######  #  #  ####  ####  #  #  #  #
#  #  #  #  #        #     #  #     #     #  #        #        #  #  #        #  #     #  #
#  #  ####  #  ####  #  #############  #  #######  #  #######  ####  ##########  #  #  #  #
#     #           #  #     #        #  #           #           #  #  #           #  #     #
#  ####  ####  #  ####  ####  #  ##########  ####  ####  #  #  #  #  ####  #######  ####  #
#  #     #     #  #     #  #  #        #     #     #  #  #  #     #  #     #     #  #     #
#  #  #  #  ##########  #  #  ##########  ##########  #  #############  #######  ##########
#  #  #  #        #  #  #                 #  #        #        #  #     #  #        #     #
#  ####  ####  ####  #  ####  #  ##########  #######  ####  ####  #  #  #  #  #  #  #  ####
#  #  #     #           #     #  #        #              #  #     #  #  #     #  #     #  #
#  #  #  #############  ####  #######  #######  ####  #  #  #  #######  ####  ####  #  #  #
#        #  #     #              #                 #  #     #  #        #  #  #     #     #
#  ####  #  #  ####  #  ####  #  #######  #######  ####  ####  #######  #  #  #######  ####
#     #           #  #     #  #        #        #  #           #                    #    G#
###########################################################################################
