                              ###############################                              
                              #       #             #   #   #                              
                              ####### # ####### ### # ### # #                              
                              #     # # #     # #   #     # #                              
                              # # ### # # ##### # ######### #                              
                              # #   # #   #     #         # #                              
                              # ### # ##### ############# # #                              
                              # # # #       # #         # # #                              
                              # # # ######### # ### ##### # #                              
                              # # #           #   #   #   # #                              
                              # # # ####### ##### ### # ### #                              
                              #   # # #     #     #   # #   #                              
################################### # # ##### ##### ### # # ###############################
#S#     #         #           #   # #   # #   #   #   # # #           #               #   #
# # # ### # ####### ####### # # # # # ### # ### # ### # ####### ### # ######### ##### ### #
#   # #   #         # #     #   #   #     #   # #   # #       # #   #     #     #   #     #
##### # ############# # ####### ######### ### # ### # ####### ### ####### # ####### ##### #
#     # #       #     # #       #   #       #   # # #   #   #     #     #   #           # #
# ##### ### ### ### ### ######### # # ########### # # # # ######### # ########### ####### #
# #   # #   # #   #   # #   #     # #   #     #     # #   #         # #           #   #   #
# # # # # ### ### # # # # # # ##### ### # ### # ##### ### # # ####### # ### ### ### # # ###
# # #   #   #   # # # #   # # #     # # # # #   #   # #   # # #   #   # # # #   #   # # # #
# # ####### # ### ### ##### # # ##### # # # ##### ### ##### # # # ##### # # ##### ### # # #
#   #   #   #     #   #   # # # #   #   #   # #     #       # # # #   #   #     # #   #   #
# ### # # ### ##### # ### # # # # # # ##### # # ### ######### # # # # ### ##### # # ##### #
#     #   #         #     #   # # # # # #   # # #           #   #   #         #   #      G#
############################### ### # # # ### # # ######### ###############################
                              #   #     # #     # #     # # #                              
                              ### ##### # ##### # # ### # # #                              
                              #   #   # #     # #     # #   #                              
                              # # # # ####### ######### # ###                              
                              # # # #     #   #     #   # # #                              
                              # # # ##### # ### ### # ### # #                              
                              # # # #   # #   # # # # #     #                              
                              # # # # # # ### # # # # ##### #                              
                              # # # # # #   # # # # #     # #                              
                              # ### ### ### # # # # ##### # #                              
                              #           #     #         # #                              
                              ###############################                              
