###########################################################################################
#S    #     #   #     #   #     #             #             #           #       #     #   #
##### # # ### # # # # # # # ### ##### # ##### ##### # ####### ####### # ### ### # ### # # #
#   # # # #   #   # # # # # # #     # # #   #   #   # #     #       # #     #   #   # # # #
# ### # # # ####### # # # # # ##### # # ### ### # ### # ### ### ##### ############# # # # #
#     # # # #     # #   #   #     # # #   #     #   # #   #     #     #       #     # # # #
# ##### # # # ### # ######### # ### ##### # ####### # ### ####### ### # ##### # ##### # # #
#     # # # # # #   #   #   # #   #       #   #     # #   #       #   # #   #   #   #   # #
##### # # # # # ##### # # # ##### ########### ### ##### ### ####### ### ### ##### ####### #
# #   # #   # #   #   #   #   #     #       #   # #     # # #   #     #     #     #     # #
# # ##### ### ### # # ####### # ### ##### ##### # # ##### # # # ########### ##### # ### # #
# #     # # #   #   # #   #   # #         #     # #   #   # # #                 #     # # #
# ##### # # ### ### # # # ### # ####### ### ##### ### # # # # ################# ##### # # #
#       #     #   # #   #   #   #   #   #   #   #   #   # # #       #     #       #   # # #
# ########### ### # ####### ### # # # ### ### # # # ##### # ##### ### ### ####### ##### # #
#     #     #   # # # #     #   # # # #   #   # # #   #   #       #   # #     #   #     # #
##### ### # ### # # # # ### ##### # ### ### # ### ### # ########### ### ##### # ### ### # #
#   #     #   # # #   # #   #     #   #   # # #   # # #   #     #   #   #   # #     #   # #
# ########### # # ### # ##### ####### ### # # # ### # ### # ##### ### ### # # ####### ### #
# #           # #   # #       #     #   # # #       #       #   # #       #   #   # #   # #
# # ############### # ######### ### ### # ####### ######### # # # # ########### # # ### # #
# # #       #     # #   #     # #       #     #   #     #   # #   # #   #       #   #   # #
# # ### ### # ### # ### # ### # ############# ##### ### ##### ##### # # ####### ##### ### #
# # #   #   # # # # #     #   # #         #   #     # #     # # #   # #       #   #   #   #
# # # ### ### # # # # ######### # ##### # # ### ##### ##### # # # ### ####### # # # ### ###
# #   # #     # #   #   #       # #   # # #   # #         #   # #   # #     # # #     #   #
# ##### ####### ######### ##### # ### # ##### # # # # ######### ### # ### # # ########### #
#   #                     #   # #     #       # # # # #     # #     #   # # #             #
# # # ############# ######### # ##### ######### # # ### # # # # ####### # ############### #
# # #     #         #       # # # #   #         # #   # # #   #   #   # #         #       #
# ####### # ####### # ##### # # # # ######### # ##### # # ####### # # # # ### # ### #######
#   #     #   #     # # #   #     #         # #   #   # #     #   # #   #   # # #   #     #
# # # ####### # ##### # # # ############### # ### # # # ##### # ### ######### ### ####### #
# #   #     # #     #   # # #           # # # #   # # #     # # #     #       #   #       #
# ##### ### # ### ##### # ### ### ##### # # # # ### ##### ### # ##### ### ### # ### ##### #
# #   #   # #   # #     # #   #   #   #   # # # # #       #   #     # #   #   # #   # #   #
# # # ##### ### ### ##### # ### ### # ##### ### # # ####### ####### # # ####### # ### # ###
#   #         #         #     #     #           #         #           #           #      G#
###########################################################################################
