##################################################
#S#       #           #                 #        #
# # ##### # ####### # # ############### # ###### #
#   #   #   #     # # # #               # #    # #
##### # ####### # # # # # ########## #### # ## # #
#     #         # # # # # #             # #  # # #
# ############# # # # # # # ########### # ## # # #
# #           # # # #   # # #         # #    # # #
# # ######### # # # ##### # # ####### # ###### # #
# # #       # # # #       # # #     # #        # #
# # # ##### # # # ######### # ##### # ########## #
# # # #   # # # #           # #   # #            #
# # # # # # # # ############# # # # ############ #
# # # # # # # #               # #                #
# # # # # # # ################# # ################
# # #   #   #                   #                #
# # ##### ####################### ############## #
# #       #                     # #            # #
# ######### ################### # # ########## # #
#           #                 # # # #        # # #
########### # ############### # # # # #### # # # #
#           # #             # # # # # #    # # # #
# ########### # ########### # # # # # # ## # # # #
# #           # #         # # #   # # #  # # # # #
# # ######### # # ####### # # ##### # ## # # # # #
# # #       # # # #     # # #       #    # # # # #
# # # ##### # # # ##### # # ######### #### # # # #
# # # #   # # # # #   # # #                # # # #
# # # # # # # # # # # # # ################## # # #
# # # # # # # # # # # # #                    #   #
# # # # # # # # # # # # ###################### # #
#   #   #   #   #   #   #                      # #
##### ##### ##### ##### # ###################### #
#                       # #                    # #
# ####################### # ################## # #
# #                       # #                # # #
# # ####################### # ############## # # #
# # #                       # #            # # # #
# # # ####################### # ########## # # # #
# # # #                       # #        # #   # #
# # # # ####################### # ###### # ##### #
# # #   #                       # #    # #       #
# # ##### ####################### # ## # #########
# #       #                       #  # #         #
# ######### ####################### ## ######### #
#                                   #          # #
# ############################################ # #
#                                              #G#
##################################################
