                                                #####                                                
                                              ## #S  #                                               
                                            #### ### ###                                             
                                           #     # # # ##                                            
                                          #### # # # # ####                                          
                                        ##     # # # #     #                                         
                                      #### # ### # # ### #####                                       
                                     #   # #   #   #   #     ##                                      
                                    ## # # ### # ##### # ### ####                                    
                                  ##   # #   # # #     # #       #                                   
                                #### # ##### # ### ####### #########                                 
                               #     #     # #     #       #       ##                                
                              ## ####### # # ########### ### ### # ####                              
                            ## #   #   # # #   #       # #   #   # #   #                             
                          #### ### # ### # ### # ##### # # ### ### # # ###                           
                         #       #   #   #   # #   # # # # # # #     #   ##                          
                        ###### # ### # ####### ### # # # # # # ##############                        
                      ##       # #   #       #   # #     #   #       #       #                       
                    ###### # ##### ######### ### # # ####### ####### # # ### ###                     
                   #       # #   # #       #   # # # #       # #     # # # #   ##                    
                  #### # ##### # # # ### ##### # # ### ####### # ##### # # ### ####                  
                ##     # #   # #   #   #   #   # #   #   #   # #       # #   # #   #                 
              #### ####### # # ########### # ### ### ### # # # ######### # ### # # ###               
             #     #       #   # #         # #   #   #     # #   #     # #   #   #   ##              
            ## # ### ########### # # ### ### # ### ### ##### # # ### # # # # ####### ####            
          ##   # #   #   #   #     # #   #   # #       #   #   #     # # # #       #     #           
        #### ### # ### # ### # ##### ##### ### ##### ### # ######### ### # ### # ####### ###         
       # #     # # #   #   #       # #     #   #   #   # #         # #   # # # # #     # # ##        
      ## # ### ### # ##### ######### # ##### ### # ##### ######### ### ### # # ### ### # # ####      
    ##       #       #               #           #       #             #     #       #       G #     
   ###############################################################################################   
